|_____________________________________________________________________________|
|.............................................................................|
|.............................................................................|
|.............................................................................|
|.............................................................................|
|.............................................................................|
|.............................................................................|
|.............................................................................|
|.............................................................................|
|.............................................................................|
|.............................................................................|
|.............................................................................|
|.............................................................................|
|.............................................................................|
|............................$$$..............................................|
|.............................................................................|
|.............................................................................|
|.............................................................................|
|.............................................................................|
|.............................................................................|
|.............................................................................|
|.............................................................................|
|.............................................................................|
|.............................................................................|
|.............................................................................|
|.............................................................................|
|.............................................................................|
|.............................................................................|
|.............................................................................|
|_____________________________________________________________________________|