|_____________________________________________________________________________|
|.............................................................................|
|.............................................................................|
|.............................................................................|
|.....................//////////////////////////////..........................|
|.............................................................................|
|.............................................................................|
|.............................................................................|
|.............................................................................|
|.............................................................................|
|.............................................................................|
|.............................................................................|
|.............................................................................|
|.............................................................................|
|..............................$$$$$$$$$$.....................................|
|..............................$$$$$$$$$......................................|
|..............................$$$$$$$$$......................................|
|..............................$$$$$$$$$......................................|
|.............................................................................|
|.............................................................................|
|.............................................................................|
|.............................................................................|
|.............*...............................................................|
|............***..............................................................|
|...........*****.............................................................|
|...........*****.............................................................|
|...........*****.............................................................|
|...........*****.............................................................|
|.............................................................................|
|_____________________________________________________________________________|